%%%%%%%%%%%%%%%%%
%              P%
%  %%%%%%%%%%%%%%
%               %
%%%%%%%%%%%     %
%       %       %
% .  %          %
%%%%%%%%%%%%%%%%%