%%%%%%%%%%%%%%%%%%%%%%%%%%%%%%%
%                            P%
% %%%%%%%%%                   %
%         %                   %
%         %                   %
%         %%%%%%%%%%%%%%      %
%         %                   %
%         %                   %
%       . %                   %
%%%%%%%%%%%%%%%%%%%%%%%%%%%%%%%