%%%%%%%%%%%%%%%%%%%%%%%%%%%%%%%
%                            P%
%%%%%%%%%%%                   %
%                             %
%                             %
%           %%%%%%%%%%%%%     %
%                             %
%                             %
%       . %                   %
%%%%%%%%%%%%%%%%%%%%%%%%%%%%%%%