%%%%%%%%%%%%%%%%%%%%%%%%%%%%%%%%%%%%%%%%%%%%%%%%%%%%%
%                                                % P%
%                                                %  %
%                                                %  %
%      %%%%%%%%%%%%%%%%%%%%%%%%%%%%%%%%%         %  %
%      %                               %         %  %
%      %   %%%%%%%%%%%%%%%%%%%%%       %         %  %
%      %   %   G   %          .%       %         %  %
%      %   %       %     %%%%%%%       %         %  %
%      %   %       %                   %         %  %
%      %   %%%%%%%%%%%%%%%%%%%%%%%%%%%%%         %  %
%      %                                         %  %
%      %%%%%%%%%%%%%%%%%%%%%%%%%%%%%%%%%%%%%%%%%%%  %
%                                                   %
%%%%%%%%%%%%%%%%%%%%%%%%%%%%%%%%%%%%%%%%%%%%%%%%%%%%%