%%%%%%%%%%%%%%%%%%%%%%%%
%%%%%%%%%%%           P%
%%%%%%      %%%%%%%%%% % 
%%%.               %   % 
%%%%%%%%%%%%%%%%%%%%%%%%