%%%%%%%%%%%%%%%
%   P    ...  %
%        %%%%%%
%.... %       %
%%         .. %
%     %%      %
% ..      % . %
%%%%%%%%%%%%%%%